#############
#BB.......RR#
#B#.#.#.#.#R#
#...........#
#.#.#.#.#.#.#
#...........#
#.#.#.#.#.#.#
#...........#
#G#.#.#.#.#Y#
#GG.......YY#
#############